
WE         rabbit_f1024.xpm
NO         rabbit_b1024.xpm 
C      1,20,255    
SO  rabbit_b1024.xpm
R  1300  1000 
EA     rabbit_b1024.xpm       
S    rabbit_m1024.xpm  
F 220,100,255

        1111111111111111111111111
        1000000000000000000000001
        1100000000000000000000001
        1000000000000000000000001
111111111000002000000000111111101
100000000000002222220000000001111
10N00000000000020001000000001
10000000000000000011000000001
10000000000000000000000000001
10000000000000000000000000001
10000000000000000001010000001
11000001110101011111011110101
11110111 1110121 101111010001
11111111 1111111 111111111111