NO         ./texture/rabbit_pattern.xpm 
SO  ./texture/pink_stripe1.xpm
R  10000 10000
C      80,188,223 
WE   ./texture/heart.xpm
EA     ./texture/cloud1024.xpm       
S    ./texture/rabbit_m1024.xpm
F 255,201,150  

        1111111111111111111111111
        1000000000000000000000001
        1000000000000000000000011
        1000000000000000000000001
111111111000001111100000111111101
100000000000000011100000000001111
1000200000000101S001000000001
10002000000000010011000000001
10000000000000022000000000001
10000000000000000000000000001
10000000000000000001010000001
11000001110101011111011110101
11110111 1110121 101111010001
11111111 1111111 111111111111
