WE         ./texture/cloud1024.xpm
NO         ./texture/sky1024.xpm 
C      1,20,255    
SO  ./texture/sky1024.xpm
R  109  109
EA     ./texture/sky1024.xpm       
S    ./texture/rabbit_f1024.xpm  
F 220,100,255

        1111111111111111111111111
        1000000000000000000000001
        1100000000000000000000001
        1000000000000000000000001
111111111000001111100000111111101
10000000000000000000000000001111
1000200000000101S001000000001
10002000000000010011000000001
10000000000000022000000000001
10000000000000000000000000001
10000000000000000001010000001
11000001110101011111011110101
11110111 1110121 101111010001
11111111 1111111 111111111111